WWWWWWWWWWWW
WLLLLLLLLLLW
WL$$$$$$$$LW
WL$L$$$$$$LW
WL$$$$L$$$$:
WL$L$$$$$$LW
WL$$$$$$$$LW
WLLLLLLLLLLW
WWWWWWWWWWWW