WWWWWWWWWWWW
Wjck$W$$$L$W
WCHC$W$L$$$W
WCBC$W$$$$$W
Wmpl$$$$$$$W
W$$$$W$$$L$W
W$$$LW$$$$$W
W$$$$W$L$$$W
WWWWWWWWWWWW