WWWWWWWWWWWW
Wjck$W$$$L$W
WCHC$W$L$$$W
WCBC$W$$$$$W
Wmpl$$$$$$$/
W$$$$W$$$L$W
W$$$$W$$$$$W
W$$$$W$L$$$W
WWWWWWWWWWWW