WWWWWW
Wjck$W
WCHC$W
WCBC$W
Wmpl$$.
W$$$$W
W$$$$W
W$$$$W
WWWWWW